13 11
#############
#k..........#
#........s..#
#...........#
#...s.......#
#.....c.....d
#...........#
#.....i.....#
#.........w.#
#@..........#
#############